{
	"level_number": 9,
	"level": [
		[0, 1, 0, 0, 0, 0, 0, 0, 0, 0, 0, 0, 0, 0, 0],
		[0, 1, 1, 1, 1, 1, 1, 1, 0, 0, 0, 0, 0, 0, 0],
		[0, 0, 0, 0, 0, 0, 0, 1, 0, 0, 0, 0, 0, 0, 0],
		[0, 0, 0, 0, 1, 0, 0, 1, 1, 1, 1, 1, 1, 0, 0],
		[0, 1, 1, 1, 1, 1, 1, 1, 0, 0, 0, 1, 0, 0, 0],
		[0, 1, 0, 0, 1, 0, 0, 1, 0, 0, 0, 1, 0, 0, 0],
		[0, 1, 0, 0, 1, 0, 0, 1, 0, 0, 0, 1, 0, 0, 0],
		[0, 1, 1, 1, 1, 1, 1, 1, 1, 1, 1, 1, 1, 1, 0],
		[0, 0, 0, 0, 0, 0, 0, 1, 0, 1, 0, 0, 0, 1, 0],
		[0, 0, 0, 0, 0, 0, 0, 1, 1, 1, 1, 1, 1, 1, 0],
		[0, 0, 0, 0, 0, 0, 0, 1, 0, 1, 0, 0, 0, 1, 0],
		[0, 0, 0, 0, 0, 0, 0, 1, 1, 1, 1, 1, 1, 0, 0],
		[0, 0, 0, 0, 1, 1, 1, 1, 0, 0, 0, 0, 0, 0, 0],
		[0, 0, 0, 0, 0, 0, 0, 1, 1, 1, 1, 1, 1, 1, 0],
		[0, 0, 0, 0, 0, 0, 0, 0, 0, 0, 0, 0, 0, 1, 0]
	]
}
