{
	"level_number": 6,
	"level": [
		[0, 1, 0, 0, 0, 0, 0, 0, 0, 0, 0, 0, 0, 0, 0],
		[0, 1, 0, 0, 1, 1, 1, 1, 0, 0, 0, 0, 0, 0, 0],
		[0, 1, 0, 0, 0, 0, 0, 1, 0, 0, 0, 0, 0, 0, 0],
		[0, 1, 1, 1, 1, 1, 1, 1, 0, 1, 0, 0, 0, 0, 0],
		[0, 0, 0, 0, 1, 0, 0, 1, 0, 1, 0, 1, 0, 1, 0],
		[0, 0, 0, 0, 1, 1, 1, 1, 0, 1, 0, 1, 0, 1, 0],
		[0, 0, 0, 0, 1, 0, 0, 1, 0, 1, 0, 1, 0, 1, 0],
		[0, 1, 1, 1, 1, 1, 1, 1, 1, 1, 1, 1, 1, 1, 0],
		[0, 0, 0, 0, 0, 1, 0, 1, 0, 0, 0, 0, 0, 0, 0],
		[0, 0, 0, 0, 0, 1, 0, 1, 0, 0, 0, 0, 0, 0, 0],
		[0, 0, 0, 0, 1, 1, 1, 1, 0, 0, 0, 0, 0, 0, 0],
		[0, 0, 0, 0, 0, 0, 0, 1, 0, 0, 0, 0, 0, 0, 0],
		[0, 0, 0, 0, 0, 0, 0, 1, 1, 1, 1, 1, 1, 1, 0],
		[0, 0, 0, 0, 0, 0, 0, 1, 0, 0, 0, 0, 0, 1, 0],
		[0, 0, 0, 0, 0, 0, 0, 0, 0, 0, 0, 0, 0, 1, 0]
	]
}
